NO sprites/1.png
SO sprites/1.png
WE sprites/1.png
EA sprites/1.png
DO sprites/door.png
D1 sprites/DO1.png
D2 sprites/DO2.png
D3 sprites/DO3.png
D4 sprites/DO4.png
D5 sprites/DO5.png
D6 sprites/DO6.png
D7 sprites/DO7.png
D8 sprites/DO8.png

F 255,255,255
C 0,0,0

        1111111111111111111111111
        1000000000010000000000011
        1011000000010000000000011
        100F0000000F0000000000011
11111111101100000001000S000000011
111111111000000001010000000000011
100000000011000001111111111111111
11110111111111011100000010001
11110111111111011101010010001
11000000110101011111010010001
10000000000000000000000000011        
10000000000000000000000010001
11000001110101011111011110111
11110111 1110101 101111010001
11111111 1111111 111111111111
