NO sprites/testNO.png
SO sprites/testSO.png
WE sprites/testWE.png
EA sprites/testEA.png

C 0,0,0
F 255,255,255

        1111111111111111111111111
        1000000000110000000000001
        1011000001110000000000001
        1001000000000000000000011
11111111101100000111000S000000011
100000000011000001110111111111111
11110111111111011100000010001
11110111111111011101010010001
11000000110101011111010010001
10000000000000000000000000011        
10000000000000000000000010001
11000001110101011111011110111
11110111 1110101 101111010001
11111111 1111111 111111111111
