NO   sprites/1.png
SO    sprites/2.png
WE    sprites/3.png
EA    sprites/4.png
F     255 , 255 , 255
C     0 , 0 , 0

Salut ca va

11111111111111111111111
10000000000000000000001
10000000000000000000001
10000000000000000000001
10000000111000000000001
10000000000000000000001
10000000000000000000001
10000000000000000000001
111111111111111111W1101
11111111111111111111111
